NO ./path
SO ./path
WE ./path
EA ./path
F 0,0,0
C 0,0,0

1111111
1E00201
1111111
