     NO textures/wall_n.xpm
     SO textures/wall_s.xpm
WE textures/carte.xpm    
EA textures/nyan.xpm




F 225,255,255
C 0,255,0


        1111111111111111111111111
        1N10000000110000000000001
        1111000001110000000000001
        1001000000000000000000001
111111111011000001110000000000001
100000000011000001110111111111111
11110111111111011110000010001
11110111111111011101010000001
11000000110101011100000010001
10000000000000000000000010001
10000000000000001101010010001
		oui
11000001110101111101111000111
11110111 1110101 101111010001
11111111 1111111 111111111111
00000000000000000000000000000
