     NO textures/colorstone.xpm
     SO textures/bluestone.xpm
WE textures/barrel.xpm
EA textures/purplestone.xpm

DO textures/eagle.xpm

EX textures/sprite

F 192,192,192
C 100,100,255


        1111111111111111111111111
        1000000000110000000000001
        1211000001110000000000001
        1001000002020000000000001
111111111211000001110000000000001
100000200011000001112111111111111
11110111111111011100000010001
111121111111110111010100200X1
11000000110101011100000010001
10000000000000000000000010001
10000000000000001101010010001
11000001110101211111011110N0111
11110111 1110101 101111010001
11111111 1110111 111111101111
        1111011111111111111111111
        1000000000110000000000001
        1211000001110000121210001
        1001000002020000202020001
111111111011000001110000121210001
100000000011000001112111101011111
11112111111111011100000010001
11110111111111011101010000001
11000000110101011100000010001
10000000000000000200000010001
10000000000000001101010010001
110000011101210111110111100111
11110111 1110101 101111010001
11111111 1111111 111111111111

